1111111111111111111111111
1000110000000000000000001
10C01100000P000000000C001
1000110000000000000000001
1000000000011111111111111
10000C0000011111111111111
1111000000000001111111111
100C0000000000000000E0111
1111111111111111111111111