111111111111
100000P00001
111101010001
100001E01111
100001C00111
111111111111