11111111111111111111111111111111111111
1P000000000000C000000000000000000000E1
11111111100111111111110000111111111111
11111111111111111111111111111111111111