11111111111111111111111111111111111111
1P000000000000E000000000000000000000C1
11111111100111111111110000111111111111
11111111111111111111111111111111111111