1111111111
1P0000C0E1
1111111111