11111111111111111111111111111111111111111111111
1P000000000000000E11100000001111100000000000001
1111111000000111110C0011110011100000000000000C1
11111000000001110000011110000000011111110000001
11110000000111110000111100000000011111100000011
11111110000111110011111000C00000111100001111111
10000000000000000111111000000000111110000000001
1C000000111111001111111000000000111111000000001
11111000111111001110C01111110000000000000000001
11110000011111001111000000000000000001000001111
11000001111000001111000001111111100001000111111
1110C001111000001100000001111110000000000111111
11111111111000001111100001111000000000000000001
10000000000000000000000001111C00001111111111001
1C00000000000000000000000111100000011111111C001
11111111111111111111111111111111111111111111111