11111111111
11111111111
11110111111
11110111111
1C1101111E1
11110111111
1111P111111
11111111111