1111111111
1E11111111
11111A1111
1000000001
1111P00001
1C00000001
1111111111