111111111
10C000P01
110111111
11000E011
111111110